Timestep,Steps - BLUE,Steps - ORANGE,Pressure Plates Activated - BLUE,Pressure Plates Activated - ORANGE,Blocks Placed - BLUE,Blocks Placed - ORANGE,Blocks Removed - BLUE,Blocks Removed - ORANGE,Messages Sent - BLUE,Messages Sent - ORANGE
0,0,0,0,0,0,0,0,0,0,0
1,0,0,0,0,0,0,0,0,0,0
2,0,0,0,0,0,0,0,0,0,0
3,1,1,0,0,0,0,0,0,0,0
4,1,1,0,0,0,0,0,0,0,0
5,2,2,0,0,0,0,0,0,0,0
6,2,2,0,0,0,0,0,0,0,0
7,3,3,0,0,0,0,0,0,0,0
8,3,3,0,0,0,0,0,0,0,0
9,4,4,0,0,0,0,0,0,0,0
10,4,4,0,0,0,0,0,0,0,0
11,5,5,0,0,0,0,0,0,0,0
12,5,5,0,0,0,0,0,0,0,0
13,5,5,0,0,0,0,0,0,0,0
14,5,5,0,0,0,0,0,0,0,0
15,6,5,0,0,0,0,0,0,0,0
16,7,5,0,0,0,0,0,0,0,0
17,7,5,0,0,0,0,0,0,0,0
18,8,5,0,0,0,0,0,0,0,0
19,8,5,0,0,0,0,0,0,0,0
20,9,5,1,0,0,0,0,0,0,0
21,9,5,1,0,0,0,0,0,0,0
22,9,6,1,0,0,0,0,0,0,0
23,10,6,1,0,0,0,0,0,0,0
24,10,7,1,0,0,0,0,0,0,0
25,10,7,1,0,0,0,0,0,0,0
26,11,8,1,0,0,0,0,0,0,0
27,11,8,1,0,0,0,0,0,0,0
28,12,8,1,0,0,0,0,0,0,0
29,12,9,1,0,0,0,0,0,0,0
30,12,9,1,0,0,0,0,0,0,0
31,13,9,1,0,0,0,0,0,0,0
32,14,10,1,0,0,0,0,0,0,0
33,15,10,1,0,0,0,0,0,0,0
34,15,11,1,0,0,0,0,0,0,0
35,16,11,1,0,0,0,0,0,0,0
36,16,11,1,0,0,0,0,0,0,0
37,16,12,1,0,0,0,0,0,0,0
38,17,12,1,0,0,0,0,0,0,0
39,17,12,1,0,0,0,0,0,0,0
40,18,13,1,0,0,0,0,0,0,0
41,18,13,1,0,0,0,0,0,0,0
42,19,13,1,0,0,0,0,0,0,0
43,19,13,1,0,0,0,0,0,0,0
44,20,14,1,0,0,0,0,0,0,0
45,20,14,1,0,0,0,0,0,0,0
46,21,15,1,0,0,0,0,0,0,0
47,21,15,1,0,0,0,0,0,0,0
48,21,16,1,0,0,0,0,0,0,0
49,22,16,1,0,0,0,0,0,0,0
50,22,17,1,1,0,0,0,0,0,0
51,22,17,1,1,0,0,0,0,0,0
52,22,17,1,1,0,0,0,0,0,0
53,23,17,1,1,0,0,0,0,0,0
54,23,17,1,1,0,0,0,0,0,0
55,24,17,1,1,0,0,0,0,0,0
56,24,17,1,1,0,0,0,0,0,0
57,25,17,1,1,0,0,0,0,0,0
58,25,17,1,1,0,0,0,0,0,0
59,26,17,1,1,0,0,0,0,0,0
60,26,17,1,1,0,0,0,0,0,0
61,27,17,1,1,0,0,0,0,0,0
62,27,17,1,1,0,0,0,0,0,0
63,27,17,1,1,0,0,0,0,0,0
64,28,17,1,1,0,0,0,0,0,0
65,28,17,1,1,0,0,0,0,0,0
66,29,18,1,1,0,0,0,0,0,0
67,29,18,1,1,0,0,0,0,0,0
68,30,19,1,1,0,0,0,0,0,0
69,30,19,1,1,0,0,0,0,0,0
70,30,20,1,1,0,0,0,0,0,0
71,30,20,1,1,0,0,0,0,0,0
72,30,21,1,1,0,0,0,0,0,0
