Timestep,Steps - BLUE,Steps - ORANGE,Pressure Plates Activated - BLUE,Pressure Plates Activated - ORANGE,Blocks Placed - BLUE,Blocks Placed - ORANGE,Blocks Removed - BLUE,Blocks Removed - ORANGE,Messages Sent - BLUE,Messages Sent - ORANGE
0,0,0,0,0,0,0,0,0,0,0
1,0,1,0,0,0,0,0,0,2,1
2,0,1,0,0,0,0,0,0,4,2
3,1,1,0,0,0,0,0,0,6,3
4,2,2,0,0,0,0,0,0,8,4
5,2,3,0,0,0,0,0,0,10,5
6,3,3,0,0,0,0,0,0,12,7
7,4,4,0,0,0,0,0,0,14,9
8,4,4,0,0,0,0,0,0,16,12
9,5,4,0,0,0,0,0,0,19,14
10,5,4,0,0,0,0,0,0,21,16
11,6,4,1,0,0,0,0,0,23,18
12,6,4,1,0,0,0,0,0,25,20
13,7,5,1,0,0,0,0,0,27,22
14,7,6,1,0,0,0,0,0,29,25
15,8,7,1,0,0,0,0,0,32,27
16,8,8,1,0,0,0,0,0,35,28
17,8,8,1,0,0,0,0,0,38,29
18,9,9,1,0,0,0,0,0,41,30
19,9,9,1,0,0,0,0,0,43,32
20,10,10,2,0,0,0,0,0,46,33
21,10,10,2,0,0,0,0,0,48,34
22,10,11,2,0,0,0,0,0,50,35
23,11,12,2,0,0,0,0,0,52,36
24,12,12,2,0,0,0,0,0,54,37
25,13,13,2,0,0,0,0,0,55,38
26,13,13,2,0,0,0,0,0,56,40
27,14,14,2,0,0,0,0,0,57,42
28,14,15,2,0,0,0,0,0,59,44
29,15,16,2,0,0,0,0,0,61,46
30,15,17,2,0,0,0,0,0,63,48
31,15,17,2,0,0,0,0,0,65,50
32,15,18,2,1,0,0,0,0,67,52
33,15,18,2,1,0,0,0,0,69,55
34,16,19,2,1,0,0,0,0,72,57
35,17,20,2,1,0,0,0,0,74,59
36,18,20,2,1,0,0,0,0,76,60
37,19,21,2,1,0,0,0,0,77,61
38,19,21,2,1,0,0,0,0,78,62
39,19,21,2,1,1,0,0,0,79,64
40,19,22,2,1,1,0,0,0,82,67
41,20,22,2,1,1,0,0,0,84,69
42,20,23,2,1,1,0,0,0,86,71
43,21,24,2,2,1,0,0,0,88,74
44,21,24,2,2,1,0,0,0,89,76
45,21,24,2,2,1,0,0,0,90,78
46,22,25,2,2,1,0,0,0,91,80
47,23,25,2,2,1,0,0,0,93,83
48,23,26,2,2,1,0,0,0,95,86
49,24,26,2,2,1,0,0,0,97,88
50,24,26,2,2,1,0,0,0,99,90
51,24,27,2,2,1,0,0,0,101,92
52,25,27,2,2,1,0,0,0,103,95
53,25,27,2,2,1,0,0,0,105,98
54,25,28,2,2,1,0,0,0,107,101
55,26,28,2,2,1,0,0,0,109,103
56,26,28,2,2,1,0,0,0,111,105
57,26,29,2,2,1,0,0,0,113,107
58,27,29,2,2,1,0,0,0,115,110
59,27,29,2,2,1,0,0,0,117,113
60,27,30,2,2,1,0,0,0,119,116
61,28,30,2,2,1,0,0,0,121,118
62,28,30,2,2,1,0,0,0,123,120
63,28,31,2,2,1,0,0,0,125,122
64,29,31,2,2,1,0,0,0,127,125
65,29,31,2,2,1,0,0,0,129,128
66,29,32,2,2,1,0,0,0,131,131
67,30,32,2,2,1,0,0,0,133,133
68,30,32,2,2,1,0,0,0,135,135
69,30,33,2,2,1,0,0,0,137,137
70,31,33,2,2,1,0,0,0,139,140
71,31,33,2,2,1,0,0,0,141,143
72,31,34,2,2,1,0,0,0,143,146
73,32,34,2,2,1,0,0,0,145,148
74,32,34,2,2,1,0,0,0,147,150
75,32,35,2,2,1,0,0,0,149,152
76,33,35,2,2,1,0,0,0,151,155
77,33,35,2,2,1,0,0,0,153,158
78,33,36,2,2,1,0,0,0,155,161
79,34,36,2,2,1,0,0,0,157,163
80,34,36,2,2,1,0,0,0,159,165
81,34,37,2,2,1,0,0,0,161,167
82,35,37,2,2,1,0,0,0,163,170
83,35,37,2,2,1,0,0,0,165,173
84,35,38,2,2,1,0,0,0,167,176
85,36,38,2,2,1,0,0,0,169,178
86,36,38,2,2,1,0,0,0,171,180
87,36,39,2,2,1,0,0,0,173,182
88,37,39,2,2,1,0,0,0,175,185
89,37,39,2,2,1,0,0,0,177,188
90,37,40,2,2,1,0,0,0,179,191
91,38,40,2,2,1,0,0,0,181,193
92,38,40,2,2,1,0,0,0,183,195
93,38,41,2,2,1,0,0,0,185,197
94,39,41,2,2,1,0,0,0,187,200
95,39,41,2,2,1,0,0,0,189,203
96,39,42,2,2,1,0,0,0,191,206
97,40,42,2,2,1,0,0,0,193,208
98,40,42,2,2,1,0,0,0,195,210
99,40,43,2,2,1,0,0,0,197,212
100,41,43,2,2,1,0,0,0,199,215
101,41,43,2,2,1,0,0,0,201,218
102,41,44,2,2,1,0,0,0,203,221
103,42,44,2,2,1,0,0,0,205,223
104,42,44,2,2,1,0,0,0,207,225
105,42,45,2,2,1,0,0,0,209,227
106,43,45,2,2,1,0,0,0,211,230
107,43,45,2,2,1,0,0,0,213,233
108,43,46,2,2,1,0,0,0,215,236
109,43,46,2,2,1,0,0,0,217,238
110,44,47,2,2,1,0,0,0,219,240
111,45,48,3,2,1,0,0,0,222,242
112,45,48,3,2,1,0,0,0,225,245
113,45,49,3,2,1,0,0,0,227,247
114,46,49,3,2,1,1,0,0,229,249
115,47,49,3,2,1,1,0,0,232,252
116,47,49,3,2,1,1,0,0,235,255
117,48,50,3,2,1,1,0,0,238,258
118,48,50,3,2,1,1,0,0,240,260
119,48,50,3,2,1,1,0,0,242,262
120,49,50,3,2,1,1,0,0,244,264
121,49,50,3,2,1,1,0,0,247,266
122,50,50,3,2,1,1,0,0,250,268
123,50,50,3,2,1,1,0,0,253,270
124,51,50,3,2,1,1,0,0,256,272
125,52,50,3,2,1,1,0,0,259,274
126,53,50,3,2,1,1,0,0,262,276
127,54,50,3,2,1,1,0,0,263,278
128,55,50,3,2,1,1,0,0,264,280
129,56,50,3,2,1,1,0,0,267,282
130,56,50,3,2,1,1,0,0,270,284
131,57,50,3,2,1,1,0,0,273,286
132,57,50,3,2,1,1,0,0,276,288
133,57,50,3,2,1,1,0,0,279,290
134,57,50,3,2,1,1,0,0,282,292
135,57,50,3,2,1,1,0,0,285,294
136,57,50,3,2,1,1,0,0,288,296
137,57,50,3,2,1,1,0,0,291,298
138,57,50,3,2,1,1,0,0,294,300
139,57,50,3,2,1,1,0,0,297,302
140,57,50,3,2,1,1,0,0,300,304
141,57,50,3,2,1,1,0,0,303,306
142,57,50,3,2,1,1,0,0,306,308
143,57,50,3,2,1,1,0,0,309,310
144,57,50,3,2,1,1,0,0,312,312
145,57,50,3,2,1,1,0,0,315,314
146,57,50,3,2,1,1,0,0,318,316
147,57,51,3,2,1,1,0,0,321,318
148,57,51,3,2,1,1,0,0,324,321
149,57,52,3,2,1,1,0,0,327,324
150,57,52,3,2,1,1,0,0,330,327
151,57,53,3,2,1,1,0,0,333,330
152,57,54,3,2,1,1,0,0,336,333
153,57,55,3,2,1,1,0,0,339,336
154,58,56,3,2,1,1,0,0,342,337
155,58,56,3,2,1,1,0,0,345,338
156,59,57,3,2,1,1,0,0,348,339
157,59,57,3,2,1,1,0,0,351,340
158,60,57,3,2,1,1,0,0,354,341
159,60,57,3,2,1,1,0,0,357,342
160,61,58,3,2,1,1,0,0,360,343
161,61,59,3,2,1,1,0,0,363,346
